11111111111111111111
10000000000000000001
10000000000000000001
10000000000000000001
10000000000000000001
10000000000000000001
10000000000000000001
10000000000000000001
10000000000000000001
10000000000000000001
10000000000000000001
10000000000000000001
10001110000000000001
10000000000000000001
10001110000000000001
10000000000000000001
10000111000000000001
10000000000000000001
10000000000000000001
11111111111111111111